111111111111111111111111
10CCCCCC0011111111111111
10EC11111111111111111111
1CP0000000X00000CCCCC111
111111111111111111111111