111111111
100P00001
10E001001
10C000101
111111111
