111111111
100P00001
100C01E01
100000101
111111111
