111111111111111111111111
10CCCCCC0011111111111111
10ECXXXXXXXXXXXXX1111111
1CP00XXXXXXXXXXXXXXXX111
111111111111111111111111