111111111111111111111
1PCCCCCC0011111111111
10ECC1CC0000000000011
1C0CCC1C1111101CCCCC1
111111111111111111111