111111111111111111111111
10CCCCCC00CCCCCCCCCCCCC1
10ECCCCCCCCCCCCCCCCCCC11
1CP0000000000000CCCCC111
1111CCCCCCCCCCCCCCCCCCC1
1111CCCCCCCCCCCCCCCCC111
1111111111CCCCCCCCC11111
111CCCCCCCCCCCCCCCCCCC11
111110000000000000011111
1111100000000000000CCCC1
111111111111111111111111