111111111111111111111111111111111111111111111111
10CCCCCC0011111111111111CCCCCCCCCCCCCCCCCCCCCCC1
10EC11110011111111110000000000000000000000000001
1CP0000000000000CCCCC111CCCCCCCCCCCCCCCCCCCCCCC1
111111111111111111111111111111111111111111111111