111111111111111111111111
10000000000P000000000001
111111111111111111111111
1CCCCCCCCCCECCCCCCCCCCC1
111111111111111111111111