111111111111111111111111111111
100000000000000000000001111011
1000000000000000000E0000111111
1CP000000000000000000001111011
111111111111111111111111111111